11111111111111
1C000C01C10001
10000111000101
10C111000C0001
10000C00010C01
1000010EP1C001
11111111111111