111111111
1P0000001
10B000B01
10C000C01
10B000B01
10C000C01
1000000E1
111111111