111111
100001
100001
100001
100001
100001
100001
100C01
100001
1C0001
100001
100001
100001
100001
100001
100PE1
111111